NLNLNLNLNLN
NTNTNTNTNTN
NPPPPPPPPPN
NTNTNTNTNTN
NNNNNNNNNNN

Niveau de Couilles
NNNNLLLNNNN
NPPNLLLNPPN
NPPNLLLNPPN
NPPNLLLNPPN
NNNNTTTNNNN


Niveau de Jianan
NLNLNLNLNLN
NTNTNTNTNTN
NPPPPPPPPPN
NTNTNTNTNTN
NNNNNNNNNNN

Niveau de Tomer
PPPPPPPPPPP
LNLNNLNNLNL
NNNNNNNNNNN
NNNNNNNNNNN
NNNNNNNNNNN

Laser Madness
LLLLLLLLLLL
LLLLLLLLLLL
LLLLLLLLLLL
LLLLLLLLLLL
LLLLLLLLLLL


N: normal
S: super
P: spiner
T: tank
L: laser